1,8,1,1,1
0,1,4,1,4,1,1,1,0,7,0,0,7,0
1,1,8,1
0,1,3,1,0,1,2,1
1,2,1,3,1,5
350,200,175,50,75
150,50,200,150,200,75,75,100,-750,100,150,100,100,100
100,380,30,380
200,20,160,20,200,20,160,20
160,280,120,280,60,100
40,30,40,110,40
40,40,40,60,40,40,100,160,40,30,40,40,30,40
120,40,160,40
40,40,40,40,40,40,40,40
40,40,40,40,40,100
110,40,110,110,180
380,380,380,360,380,380,320,260,300,300,300,300,300,300
460,540,420,540
680,680,680,680,680,680,680,680
760,760,760,760,760,700